+-+-+-+-+
|*  |   |
+-+ +-+ +
| | |   |
+ + + + +
| |   | |
+-+-+-+ +
|   |   |
+ + + + +
| | | | |
+ + + + +
| |   | |
+ +-+-+ +
|   |   |
+ + + + +
| |   | |
+ +-+-+-+
|       |
+-+-+-+ +
